=     v   v        O       =
=    #======#              =
=    #      #              =
=    #      #              =
=    #      #              =
= P  #      #              =
=======# = = =#=============
       #
=      #
 =     #
 ============#
             #
             #              =
=======##=#=#=#==============