#     v   v        O       #
#    H######H              #
#    H      H              #
#    H      H              #
#    H      H              #
# P  H      H              #
#######H # # #H#############
       H
#      H
 #     H
 ############H
             H
             H              #
#######HH#H#H#H##############